Date,Revenue,Expenses,Profit,Customers,UnitsSold
2024-01-01,5000,3000,2000,100,200
2024-01-02,5500,3200,2300,110,210
2024-01-03,6000,3500,2500,120,220
2024-01-04,5800,3300,2500,115,215
2024-01-05,6200,3600,2600,125,225
2024-01-06,6500,3800,2700,130,230
2024-01-07,7000,4000,3000,140,240
2024-01-08,7200,4100,3100,145,245
2024-01-09,7500,4300,3200,150,250
2024-01-10,8000,4500,3500,160,260
